"weapons/pl_gun1.wav" "sectore/pl_gun1.wav"
"weapons/pl_gun2.wav" "sectore/pl_gun2.wav"
"weapons/pl_gun3.wav" "sectore/pl_gun3.wav"
"weapons/hks1.wav"	"sectore/hks1.wav"
"weapons/hks2.wav"	"sectore/hks2.wav"
"weapons/hks3.wav"	"sectore/hks3.wav"
"pitdrone/pit_drone_attack_spike1.wav"	"sectore/pit_drone_attack_spike1.wav"
"pitdrone/pit_drone_attack_spike2.wav"	"sectore/pit_drone_attack_spike2.wav"
"pitdrone/pit_drone_alert1.wav"	"sectore/pit_drone_alert1.wav"
"pitdrone/pit_drone_alert2.wav"	"sectore/pit_drone_alert2.wav"
"pitdrone/pit_drone_alert3.wav"	"sectore/pit_drone_alert3.wav"
"pitdrone/pit_drone_die1.wav"	"sectore/pit_drone_die1.wav"
"pitdrone/pit_drone_die2.wav"	"sectore/pit_drone_die2.wav"
"pitdrone/pit_drone_die3.wav"	"sectore/pit_drone_die3.wav"
"pitdrone/pit_drone_pain1.wav"	"sectore/pit_drone_pain1.wav"
"pitdrone/pit_drone_pain2.wav"	"sectore/pit_drone_pain2.wav"
"pitdrone/pit_drone_pain3.wav"	"sectore/pit_drone_pain3.wav"
"pitdrone/pit_drone_pain4.wav"	"sectore/pit_drone_pain4.wav"
"pitdrone/pit_drone_melee_attack1.wav"	"sectore/pit_drone_melee_attack1.wav"
"pitdrone/pit_drone_melee_attack2.wav"	"sectore/pit_drone_melee_attack2.wav"
"pitdrone/pit_drone_eat.wav"	"sectore/pit_drone_eat.wav"
"pitdrone/pit_drone_hunt1.wav"	"sectore/pit_drone_hunt1.wav"
"pitdrone/pit_drone_hunt2.wav"	"sectore/pit_drone_hunt2.wav"
"pitdrone/pit_drone_hunt3.wav"	"sectore/pit_drone_hunt3.wav"
"pitdrone/pit_drone_idle1.wav"	"sectore/pit_drone_idle1.wav"
"pitdrone/pit_drone_idle2.wav"	"sectore/pit_drone_idle2.wav"
"pitdrone/pit_drone_idle3.wav"	"sectore/pit_drone_idle3.wav"
"pitdrone/pit_drone_communicate1.wav"	"sectore/pit_drone_communicate1.wav"
"pitdrone/pit_drone_communicate2.wav"	"sectore/pit_drone_communicate2.wav"
"pitdrone/pit_drone_communicate3.wav"	"sectore/pit_drone_communicate3.wav"
"pitdrone/pit_drone_communicate4.wav"	"sectore/pit_drone_communicate4.wav"